{
  "qwerty": {
    "l0": "g",
    "l1": "f",
    "l2": "d",
    "l3": "s",
    "l4": "a",
    "r0": "h",
    "r1": "j",
    "r2": "k",
    "r3": "l",
    "r4": ";",
    "l0t": "t",
    "l1t": "r",
    "l2t": "e",
    "l3t": "w",
    "l4t": "q",
    "r0t": "y",
    "r1t": "u",
    "r2t": "i",
    "r3t": "o",
    "r4t": "p",
    "l0b": "b",
    "l1b": "v",
    "l2b": "c",
    "l3b": "x",
    "l4b": "z",
    "r0b": "n",
    "r1b": "m",
    "r2b": ",",
    "r3b": ".",
    "r4b": "/",
    "L0": "G",
    "L1": "F",
    "L2": "D",
    "L3": "S",
    "L4": "A",
    "R0": "H",
    "R1": "J",
    "R2": "K",
    "R3": "L",
    "R4": ":",
    "L0t": "T",
    "L1t": "R",
    "L2t": "E",
    "L3t": "W",
    "L4t": "Q",
    "R0t": "Y",
    "R1t": "U",
    "R2t": "I",
    "R3t": "O",
    "R4t": "P",
    "L0b": "B",
    "L1b": "V",
    "L2b": "C",
    "L3b": "X",
    "L4b": "Z",
    "R0b": "N",
    "R1b": "M",
    "R2b": "<",
    "R3b": ">",
    "R4b": "?"
  },
  "colemak": {
    "l0": "d",
    "l1": "t",
    "l2": "s",
    "l3": "r",
    "l4": "a",
    "r0": "h",
    "r1": "n",
    "r2": "e",
    "r3": "i",
    "r4": "o",
    "l0t": "b",
    "l1t": "p",
    "l2t": "f",
    "l3t": "w",
    "l4t": "q",
    "r0t": "j",
    "r1t": "l",
    "r2t": "u",
    "r3t": "y",
    "r4t": ";",
    "l0b": "v",
    "l1b": "g",
    "l2b": "c",
    "l3b": "x",
    "l4b": "z",
    "r0b": "k",
    "r1b": "m",
    "r2b": ",",
    "r3b": ".",
    "r4b": "/",
    "L0": "D",
    "L1": "T",
    "L2": "S",
    "L3": "R",
    "L4": "A",
    "R0": "H",
    "R1": "N",
    "R2": "E",
    "R3": "I",
    "R4": "O",
    "L0t": "B",
    "L1t": "P",
    "L2t": "F",
    "L3t": "W",
    "L4t": "Q",
    "R0t": "J",
    "R1t": "L",
    "R2t": "U",
    "R3t": "Y",
    "R4t": ":",
    "L0b": "V",
    "L1b": "G",
    "L2b": "C",
    "L3b": "X",
    "L4b": "Z",
    "R0b": "K",
    "R1b": "M",
    "R2b": "<",
    "R3b": ">",
    "R4b": "?"
  }, 
  "colemak_dh": {
    "l0": "g",
    "l1": "t",
    "l2": "s",
    "l3": "r",
    "l4": "a",
    "r0": "m",
    "r1": "n",
    "r2": "e",
    "r3": "i",
    "r4": "o",
    "l0t": "b",
    "l1t": "p",
    "l2t": "f",
    "l3t": "w",
    "l4t": "q",
    "r0t": "j",
    "r1t": "l",
    "r2t": "u",
    "r3t": "y",
    "r4t": ";",
    "l0b": "v",
    "l1b": "d",
    "l2b": "c",
    "l3b": "x",
    "l4b": "z",
    "r0b": "k",
    "r1b": "h",
    "r2b": ",",
    "r3b": ".",
    "r4b": "/",
    "L0": "G",
    "L1": "T",
    "L2": "S",
    "L3": "R",
    "L4": "A",
    "R0": "M",
    "R1": "N",
    "R2": "E",
    "R3": "I",
    "R4": "O",
    "L0t": "B",
    "L1t": "P",
    "L2t": "F",
    "L3t": "W",
    "L4t": "Q",
    "R0t": "J",
    "R1t": "L",
    "R2t": "U",
    "R3t": "Y",
    "R4t": ":",
    "L0b": "V",
    "L1b": "D",
    "L2b": "C",
    "L3b": "X",
    "L4b": "Z",
    "R0b": "K",
    "R1b": "H",
    "R2b": "<",
    "R3b": ">",
    "R4b": "?"
  }, 
  "dvorak": {
    "l0": "i",
    "l1": "u",
    "l2": "e",
    "l3": "o",
    "l4": "a",
    "r0": "d",
    "r1": "h",
    "r2": "t",
    "r3": "n",
    "r4": "s",
    "l0t": "y",
    "l1t": "p",
    "l2t": ".",
    "l3t": ",",
    "l4t": "'",
    "r0t": "f",
    "r1t": "g",
    "r2t": "c",
    "r3t": "r",
    "r4t": "l",
    "l0b": ";",
    "l1b": "q",
    "l2b": "j",
    "l3b": "k",
    "l4b": "x",
    "r0b": "b",
    "r1b": "m",
    "r2b": "w",
    "r3b": "v",
    "r4b": "z",
    "L0": "I",
    "L1": "U",
    "L2": "E",
    "L3": "O",
    "L4": "A",
    "R0": "D",
    "R1": "H",
    "R2": "T",
    "R3": "N",
    "R4": "S",
    "L0t": "Y",
    "L1t": "P",
    "L2t": ">",
    "L3t": "<",
    "L4t": "\"",
    "R0t": "F",
    "R1t": "G",
    "R2t": "C",
    "R3t": "R",
    "R4t": "L",
    "L0b": ":",
    "L1b": "Q",
    "L2b": "J",
    "L3b": "K",
    "L4b": "X",
    "R0b": "B",
    "R1b": "M",
    "R2b": "W",
    "R3b": "V",
    "R4b": "Z"
  },
  "programmers_dvorak": {
    "l0": "i",
    "l1": "u",
    "l2": "e",
    "l3": "o",
    "l4": "a",
    "r0": "d",
    "r1": "h",
    "r2": "t",
    "r3": "n",
    "r4": "s",
    "l0t": "y",
    "l1t": "p",
    "l2t": ".",
    "l3t": ",",
    "l4t": "'",
    "r0t": "f",
    "r1t": "g",
    "r2t": "c",
    "r3t": "r",
    "r4t": "l",
    "l0b": ";",
    "l1b": "q",
    "l2b": "j",
    "l3b": "k",
    "l4b": "x",
    "r0b": "b",
    "r1b": "m",
    "r2b": "w",
    "r3b": "v",
    "r4b": "z",
    "L0": "I",
    "L1": "U",
    "L2": "E",
    "L3": "O",
    "L4": "A",
    "R0": "D",
    "R1": "H",
    "R2": "T",
    "R3": "N",
    "R4": "S",
    "L0t": "Y",
    "L1t": "P",
    "L2t": ">",
    "L3t": "<",
    "L4t": "\"",
    "R0t": "F",
    "R1t": "G",
    "R2t": "C",
    "R3t": "R",
    "R4t": "L",
    "L0b": ":",
    "L1b": "Q",
    "L2b": "J",
    "L3b": "K",
    "L4b": "X",
    "R0b": "B",
    "R1b": "M",
    "R2b": "W",
    "R3b": "V",
    "R4b": "Z"
  }
}
